1111111111111111111111111111111111111111
1000000000000000000011000000000000000001
1000000000000000000011000000000000000001
1000000000000000000011000000000000000021
1000001111000000000011000000011111111111
1000000011000000000011000000010000000001
1000000011110000000011000000010000000001
1000000000110000000000000000000000000001
1000000000110000000000000000000000000001
1000000011110000000000000000000000000001
1000000011000000000000000000000000000001
1000000011000000000000000000000000000001
1000000011000000011111111100000000000001
1000000011000000000000000100000000000001
1000000011000000000000000100000000000001
1000000011000000000000000100000000000001
1000000011000000000000000110000000000001
1000000011000000000000000110000000000331
1000000211000000000000002110000000000331
1111111111111111111111111111111111111111