1111111111111111111111111111111111111111
1000000000000000000000002000000000000001
1000000000000000000000000000000000000001
1000000000000000000000000000000000000001
1000000000000000000000000000000000000001
1000000000000000000000000000000000000001
1000000000000000000000000000000000000001
1000000000000000000000000000000000000001
1000000000000000000000000000000000000001
1000000000000000000000000000000000000001
1000000000000000000000000000000000000001
1000000000000000000000000000000000000021
1000000000000000000000000000000000000001
1000000000000000000000000000000000000001
1200000000000000000000000000000000000001
1000000000000000000000000000000000000001
1000000000000000000000000000000000000001
1000000000000000000000000000000000000331
1000000000000000000000000000000000000331
1111111111111111111111111111111111111111